
	
余佳	yujia@fsmeeting.com 1
Wind_陈雷	chenlei@fsmeeting.com 1
Teck_周华辉	zhouhh@fsmeeting.com 1
White_闫珂飞	yankf@fsmeeting.com 1
Nick_张弦	zhangxian@fsmeeting.com 1
kite_陈新文	chenxw@fsmeeting.com 1
RITA_王诗卉	wangsh@fsmeeting.com 1
唐运河	tangyh@fsmeeting.com 1
Chris_杨标	yangbiao@fsmeeting.com 1
王柏钢	wangbg@fsmeeting.com 1
柯泽松	kezs@fsmeeting.com 1
Daniel_袁良骅	yuanlh@fsmeeting.com 1
Rojack_李荣杰	lirj@fsmeeting.com 1
陈义南	chenyn@fsmeeting.com 1
Kevin_徐超	xuchao@fsmeeting.com 1
Gary_肖磊	xiaolei@fsmeeting.com 1
Jessie_周青	zhouqing@fsmeeting.com 1
Albert_陈晖	chenhui@fsmeeting.com 1
何永德	heyd@fsmeeting.com 1
Mary_马莉荣	malr@fsmeeting.com 1
平台7	platformlib@fsmeeting.com 1
Tony_倪元勋	niyx@fsmeeting.com 1
Devin_刘志豪	liuzh@fsmeeting.com 1
Joe_刘军平	liujp@fsmeeting.com 1
刘金财	liujc@fsmeeting.com 1
安黄彬	anhb@fsmeeting.com 1
彭玲	pengling@fsmeeting.com 1
Jack_谢威	xiewei@fsmeeting.com 1
思文伟	siww@fsmeeting.com 1
周业成	zhouyc@fsmeeting.com 1
Alvin_艾朝	aizhao@fsmeeting.com 1
Chamwen_周倩雯	zhouqw@fsmeeting.com 1
Sterry_薛峰	xuefeng@fsmeeting.com 1
	
Star_李承兴	licx@fsmeeting.com 2
Smith_张益博	zhangyb@fsmeeting.com 2
gavin_万广义	wangy@fsmeeting.com 2
丁明明	dingmm@fsmeeting.com 2
李叶丽	liyl@fsmeeting.com 2
Sky_申碧波	shenbb@fsmeeting.com 2
Martin_王寅	wangyin@fsmeeting.com 2
刘轶材	liuyc@fsmeeting.com 2
李乾科	liqk@fsmeeting.com 2
Emmy_郑点	zhengdian@fsmeeting.com 2
Paul_李伟	liwei@fsmeeting.com 2
Davis_彭代伍	pengdaiwu@fsmeeting.com 2
Wilson_李旭炜	lixw@fsmeeting.com 2
Bermuda_梁娟兰	liangjl@fsmeeting.com 2
Rose_邓燮霜	dengxs@fsmeeting.com 2
Jessica_肖旖	xiaoyi@fsmeeting.com 2
朱志信	zhuzx@fsmeeting.com 2
钟勇	zhongyong@fsmeeting.com 2
Loki_李海鹏	lihp@fsmeeting.com 2
Money_张帮钱	zhangbq@fsmeeting.com 2
刘智民	liuzm1@fsmeeting.com 2
Lrina_刘征	liuzheng@fsmeeting.com 2
Rachel_刘燕	liuyan@fsmeeting.com 2
吴昌文	wucw@fsmeeting.com 2
叶光进	yegj@fsmeeting.com 2
zheng_郑堂君	zhengtj@fsmeeting.com 2
Allen_张祥涛	zhangxt@fsmeeting.com 2
Brace_尧新星	yaoxx@fsmeeting.com 2
faker_王川	wangchuan@fsmeeting.com 2
李一航	liyh@fsmeeting.com 2
FRANK_肖江红	xiaojh@fsmeeting.com 2
江加威	jiangjw@fsmeeting.com 2
Will_熊臻	xiongzhen@fsmeeting.com 2
Triave_张凯旋	zhangkx@fsmeeting.com 2
Louis_龚一涛	gongyt@fsmeeting.com 2
孙秀莲	sunxl@fsmeeting.com 2
Boliya_杨俊	yangjun@fsmeeting.com 2
Sunny_陈红霞	chenhx@fsmeeting.com 2
wayne_代感感	daigg@fsmeeting.com 2
Katharine_杨静静	yangjj@fsmeeting.com 2
Moore_莫龙兵	molb@fsmeeting.com 2
吴雪冬	wuxd@fsmeeting.com 2
Irina_邹博琼	zoubq@fsmeeting.com 2
Zula_张露	zhanglu@fsmeeting.com 2
Sarah_张绒	zhangrong@fsmeeting.com 2
孟春生	mengcs@fsmeeting.com 2
Double_吴文艳	wuwy@fsmeeting.com 2
Shelly_陈丽	chenli@fsmeeting.com 2
Dick_卞宁	bianning@fsmeeting.com 2

洪叶露	hongyl@fsmeeting.com 7	
Doris_何美平	hemp@fsmeeting.com 7
fancy_魏湲湲	weiyy@fsmeeting.com 7

Jessie_徐洁	xujie@fsmeeting.com 7
周珑	zhoulong@fsmeeting.com 7
Tom_黄啟河	huangqh@fsmeeting.com 7
Lily_余华丽	yuhl@fsmeeting.com 7
Cici_杨莉琼	yanglq@fsmeeting.com 7
	
Alan_黄照凯	huangzk@fsmeeting.com 7
Jerry_詹林	zhanlin@fsmeeting.com 7
roy_罗剑峰	luojf@fsmeeting.com 7
	
Ryan_雷洪恩	leihe@fsmeeting.com 7
Gino?Chou_周金瑜	zhoujy@fsmeeting.com 7
	
serena_杨婷	yangting@fsmeeting.com 3
谌祺	chenqi@fsmeeting.com 3
占求辉	zhanqh@fsmeeting.com 3
Joseph_刘晓辉	liuxh@fsmeeting.com 3
Rain_王朝晖	wangzh@fsmeeting.com 3
COCO_乔明桃	qiaomt@fsmeeting.com 3
Adolphe_聂云霄	nieyx@fsmeeting.com 3
Paul_王思聪	wangsc@fsmeeting.com 3
Prefect_杨旭周	yangxz@fsmeeting.com 3
朱一松	zhuys@fsmeeting.com 3
Peter_谢平	xieping@fsmeeting.com 3
Solin_单志林	shanzl@fsmeeting.com 3
Nero.Liu_刘雍琪	liuyq@fsmeeting.com 3
刘飞飞	liuff@fsmeeting.com 3
Denny_邓潇伶	dengxl@fsmeeting.com 3
张永朝	zhangyz@fsmeeting.com 3
walter_常伟	changwei@fsmeeting.com 3
谢奇恩	xieqe@fsmeeting.com 3
赵磊	zhaolei@fsmeeting.com 3
Kevin_陈星星	chenxx@fsmeeting.com 3
Duncan_戴亨祝	daihz@fsmeeting.com 3
Lucy_张露	zhangl@fsmeeting.com 3
严海东	yanhd@fsmeeting.com 3
陈健虞	chenjy@fsmeeting.com 3
刘时	liushi@fsmeeting.com 3
luke_刘学义	liuxy@fsmeeting.com 3
Augus_朱沛杰	zhupj@fsmeeting.com 3
Ray_彭友林	pengyl@fsmeeting.com 3
欧建龙	oujl@fsmeeting.com 3
Ryan_徐冉	xuran@fsmeeting.com 3
Vince_骆军	luojun@fsmeeting.com 3
Levi_李兴平	lixp@fsmeeting.com 3
向超	xiangchao@fsmeeting.com 3
Alice_王晴	wangqing@fsmeeting.com 3
BEN_揭涛奇	jietq@fsmeeting.com 3
John_袁金生	yuanjs@fsmeeting.com 3
Jimmy_周龙	zhoul@fsmeeting.com 3
Ray_朱耿	zhugeng@fsmeeting.com 3
Oridea_唐林杰	tanglj@fsmeeting.com 3
Quan_刘小泉	liuxq@fsmeeting.com 3
lyn_陈全林	chenql@fsmeeting.com 3
shmily_陈世武	chensw@fsmeeting.com 3
Frank_付飞	fufei@fsmeeting.com 3
infelt_刘阳	liuyang@fsmeeting.com 3
彭敏	pengmin@fsmeeting.com 3
代敏	daimin@fsmeeting.com 3
范金波	fanjb@fsmeeting.com 3
杨林	yanglin@fsmeeting.com 3
Mary_雷燕飞	leiyf@fsmeeting.com 3
张敏	zhangmin@fsmeeting.com 3
皮春寒	pich@fsmeeting.com 3
王岩	wangyan@fsmeeting.com 3
李冬林	lidl@fsmeeting.com 3
杨成明	yangcm@fsmeeting.com 3
杨霞	yangxia@fsmeeting.com 3
杨江波	yangjb@fsmeeting.com 3
王聪	wangcong@fsmeeting.com 3
黄林平	huanglp@fsmeeting.com 3
徐杰	xuj@fsmeeting.com 3

胡俊秋	hujq@fsmeeting.com 4
Arthur_刘峰	liufeng@fsmeeting.com 4
Hannah_周津函	zhoujh@fsmeeting.com 4
熊娟	xiongjuan@fsmeeting.com 4
Bob_周定波	zhoudb@fsmeeting.com 4
周志远	zhouzy@fsmeeting.com 4
Justin_李俊奇	lijq@fsmeeting.com 4
Fred_周鹏飞	zhoupf@fsmeeting.com 4
邓旭光	dengxg@fsmeeting.com 4
刘明	liuming@fsmeeting.com 4
Jelly_吴治凤	wuzf@fsmeeting.com 4
刘明龙	liuml@fsmeeting.com 4
邬亚平	wuyp@fsmeeting.com 4
Pearl_胡悔	huhui@fsmeeting.com 4
王歧东	wangqd@fsmeeting.com 4
	


